%%%%%%%%%%%%%
%     %     %
% %%% %     %
% % % %%%%%%%
% % %P     .%
% % % %%%%% %
% %%% %%%%% %
%           %
%%%%%%%%%%%%%